












							:::        ::::::::      :::     ::::::::: ::::::::::: ::::    :::  ::::::::                   
							:+:       :+:    :+:   :+: :+:   :+:    :+:    :+:     :+:+:   :+: :+:    :+:                  
							+:+       +:+    +:+  +:+   +:+  +:+    +:+    +:+     :+:+:+  +:+ +:+                         
							+#+       +#+    +:+ +#++:++#++: +#+    +:+    +#+     +#+ +:+ +#+ :#:                         
							+#+       +#+    +#+ +#+     +#+ +#+    +#+    +#+     +#+  +#+#+# +#+   +#+#                  
							#+#       #+#    #+# #+#     #+# #+#    #+#    #+#     #+#   #+#+# #+#    #+#      
							########## ########  ###     ### ######### ########### ###    ####  ########       ##  ##  ##